RRRRRRRRRRRRRRRRRRRRRRRRRRRRRRRRRRRRRRRRRRRRRRRRRRRRRRRRRRRRRRRRRRRRRRRRRRRRRRRRRRRRRRRRRRRRRRRRRRRR
RBBBBBBBBBBBBBBBBBBBBBBBBBBBBBBBBBBBBBBBBBBBBBBBBBBBBBBBBBBBBBBBBBBBBBBBBBBBBBBBBBBBBBBBBBBBBBBBBBBR
RBBBBBBBBBBBBBBBBBBBBBBBBBBBBBBBBBBBBBBBBBBBBBBBBBBBBBBBBBBBBBBBBBBBBBBBBBBBBBBBBBBBBBBBBBBBBBBBBBBR
RBBBBBBBBBBBBBBBBBBBBBBBBBBBBBBBBBBBBBBBBBBBBBBBBBBBBBBBBBBBBBBBBBBBBBBBBBBBBBBBBBBBBBBBBBBBBBBBBBBR
RBBBBBBBBBBBBBBBBBBBBBBBBBBBRRRRRBBRRRBBBBBBBBBBBBBBBBBBBBBBBBBBBBBBBBBBBBBBBBBBBBBBBBBBBBBBBBBBBBBR
RBBBBBBBBBBBBBBBBBBBBBBBBBBBRAAAAAAAARBBBBBBBBBBRRRRRRRRBBRRRRRRRRBBBBBBBBBBBBBBBBBBBBBBBBBBBBBBBBBR
RBBBBBBBBBBBBBBBBBBBBBBBBBBBRAAAAAAAARBBBBBBBBBBRGGGGGGGGGGGGGGGGRBBBBBBBBBBBBBBBBBBBBBBBBBBBBBBBBBR
RBBBBBBBBBBBBBBBBBBBBBBBBBBBRAAAAAAAARBBBBBBBBBBRGGGGGGGGGGGGGGGGRBBBBBBBBBBBBBBBBBBBBBBBBBBBBBBBBBR
RBBBBBRRRRRRRRRBBBBBBBBBBBBBRAAAAAAAARBBBBBBBBBBRGGGGGGGGGGGGGGGGRBBBBBBRRRRRRRRRRRRRRRRRRRRBBBBBBBR
RBBBBBREEEEEEERBBBBBBBBBBBBBRAAAAAAAARBBBBBBBBBBRGGGGGGGGGGGGGGGGRBBBBBBRAAAAAAAAAAAAAAAAAARBBBBBBBR
RBBBBBRELEEELERBBBBBBBBBBBBBRRRRRRRRRRBBBBBBBBBBRGGGGGGGGGGGGGGGGRBBBBBBRAAAAAAAAAAAAAAAAAABBBBBBBBR
RBBBBBREEEEEEEBBBBBBBBBBBBBBBBBBBBBBBBBBBBBBBBBBRGGGGGGGGGGGGGGGGRBBBBBBRAAAAAAAAAAAAAAAAAABBBBBBBBR
RBBBBBREEELEEEBBBBBBBBBBBBBBBBBBBBBBBBBBBBBBBBBBRGGGGGGGGGGGGGGGGRBBBBBBRAAAAAAAAAAAAAAAAAARBBBBBBBR
RBBBBBREEEEEEERBBBBRRRRRRRBBRRRRRRRRRRRRBBBBBBBBRGGGGGGGGGGGGGGGGRBBBBBBRAAAAAAAAAAAAAAAAAARBBBBBBBR
RBBBBBREELEELERBBBBRTTTTTTTTTTTTTTTTTTTRBBBBBBBBRGGGGGGGGGGGGGGGGRBBBBBBRAAAAAAAAAAAAAAAAAARBBBBBBBR
RBBBBBREEEEEEERBBBBRTTTTTTTTTTTTTTTTTTTRBBBBBBBBRGGGGGGGGGGGGGGGGRBBBBBBRAAAAAAAAAAAAAAAAAARBBBBBBBR
RBBBBBRRRRRRRRRBBBBRTTTTTTTTTTTTTTTTTTTRBBBBBBBBRGGGGGGGGGGGGGGGGRBBBBBBRAAAAAAAAAAAAAAAAAARBBBBBBBR
RBBBBBBBBBBBBBBBBBBRTTTTTTTTTTTTTTTTTTTRBBBBBBBBRRRRRRRRRRRRRRRRRRBBBBBBRAAAAAAAAAAAAAAAAAARBBBBBBBR
RBBBBBBBBBBBBBBBBBBRTTTTTTTTTTTTTTTTTTTRBBBBBBBBBBBBBBBBBBBBBBBBBBBBBBBBRAAAAAAAAAAAAAAAAAARBBBBBBBR
RBBBBBBBBBBBBBBBBBBRTTTTTTTTTTTTTTTTTTTRBBBBBBBBBBBBBBBBBBBBBBBBBBBBBBBBRAAAAAAAAAAAAAAAAAARBBBBBBBR
RBBBBBBBBBBBBBBBBBBRTTTTTTTTTTTTTTTTTTTRBBBBBBBBBBBBBBBBBBBBBBBBBBBBBBBBBAAAAAAAAAAAAAAAAAARBBBBBBBR
RBBBBBBBBBBBBBBBBBBRTTTTTTTTTTTTTTTTTTTRBBBBBBBBBBBBBBBBBBBBBBBBBBBBBBBBRAAAAAAAAAAAAAAAAAARBBBBBBBR
RBBBBBBBBBBBBBBBBBBRTTTTTTTTTTTTTTTTTTTRBBBBBBBBBBBBBBBBBBBBBBBBBBBBBBBBRAAAAAAAAAAAAAAAAAARBBBBBBBR
RBBBBBRRRRRRRRRRRRBRTTTTTTTTTTTTTTTTTTTRBBBBBBBBBBBBBRRRRRRRRRRRBBBBBBBBRAAAAAAAAAAAAAAAAAARBBBBBBBR
RBBBBBRAAAAAAAAAARBRTTTTTTTTTTTTTTTTTTTRBBBBBBBBBBBBBRSSSSSSSSSRBBBBBBBBRAAAAAAAAAAAAAAAAAARBBBBBBBR
RBBBBBRAAAAAAAAAARBRTTTTTTTTTTTTTTTTTTTRBBBBBBBBBBBBBRSSSSSSSSSRBBBBBBBBRAAAAAAAAAAAAAAAAAARBBBBBBBR
RBBBBBRAAAAAAAAAARBRTTTTTTTTTTTTTTTTTTTRBBBBBBBBBBBBBRSSSSSSSSSBBBBBBBBBRAAAAAAAAAAAAAAAAAARBBBBBBBR
RBBBBBRAAAAAAAAAARBRTTTTTTTTTTTTTTTTTTTRBBBBBBBBBBBBBRSSSSSSSSSBBBBBBBBBRAAAAAAAAAAAAAAAAAARBBBBBBBR
RBBBBBRAAAAAAAAAARBRTTTTTTTTTTTTTTTTTTTRBBBBBBBBBBBBBRSSSSSSSSSBBBBBBBBBRRRRRRRRRRRRRRRRRRRRBBBBBBBR
RBBBBBRAAAAAAAAAARBRTTTTTTTTTTTTTTTTTTTRBBBBBBBBBBBBBRSSSSSSSSSRBBBBBBBBBBBBBBBBBBBBBBBBBBBBBBBBBBBR
RBBBBBRAAAAAAAAAARBRTTTTTTTTTTTTTTTTTTTRBBBBBBBBBBBBBRSSSSSSSSSRBBBBBBBBBBBBBBBBBBBBBBBBBBBBBBBBBBBR
RBBBBBRAAAAAAAAAARBRRRRRRRRRRRRRRRBRRRRRBBBBBBBBBBBBBRSSSSSSSSSRBBBBBBBBBBBBBBBBBBBBBBBBBBBBBBBBBBBR
RBBBBBRAAAAAAAAAARBBBBBBBBBBBBBBBBBBBBBBBBBBBBBBBBBBBRRRRRRRRRRRBBBBBBBBBBBBBBBBBBBBBBBBBBBBBBBBBBBR
RBBBBBRRRRRRBRRRRRBBBBBBBBBBBBBBBBBBBBBBBBBBBBBBBBBBBBBBBBBBBBBBBBBBBBBBBBBBBBBBBBBBBBBBBBBBBBBBBBBR
RBBBBBBBBBBBBBBBBBBBBBBBBBBBBBBBBBBBBBBBBBBBRRRRRRRRRRRRRBBBBBBBBBBBBBBBBBBBBBBBBBBBBBBBBBBBBBBBBBBR
RBBBBBBBBBBBBBBBBBBBBBBBBBBBBBBBBBBBBBBBBBBBRAAAAAAAAAAARBBBBBBBBBBBBBBBBBBBBBBBBBBBBBBBBBBBBBBBBBBR
RBBBBBBBBBBBBBBBBBBBBBBBBBBBBBBBBBBBBBBBBBBBRAAAAAAAAAAARBBBBBBBBBBBBBBBBBBBBBBBBBBBBBBBBBBBBBBBBBBR
RBBBBBBBBBBBBBBBBBBBBBBBBBBBBBBBBBBBBBBBBBBBRAAAAAAAAAAARBBBBBBBBBBBBBBBBBBBBBBBBBBBBBBBBBBBBBBBBBBR
RBBBBBBBBBBBBBBBBBBBBBBBBBBBBBBBBBBBBBBBBBBBRAAAAAAAAAAARBBBBBBBBBBBBBBBBBBBRRRRRRRRRRRRRRRRRRRRBBBR
RBBBBBBBBBBBBBBBBBBBBBBBBBBBBBBBBBBBBBBBBBBBRAAAAAAAAAAARBBBBBBBBBBBBBBBBBBBRSSSSSSSSSSSSSSSSSSRBBBR
RBBBBBBBRRRRRRRRRRRBBRRRRRRRRRRRBBBBBBBBBBBBRAAAAAAAAAAARBBBBBBBBRRRRRRRRRBBRSSSSSSSSSSSSSSSSSSRBBBR
RBBBBBBBRSSSSSSSSSSSSSSSSSSSSSSRBBBBBBBBBBBBRAAAAAAAAAAARBBBBBBBBRTTTTTTTRBBRSSSSSSSSSSSSSSSSSSRBBBR
RBBBBBBBRSSSSSSSSSSSSSSSSSSSSSSRBBBBBBBBBBBBRAAAAAAAAAAARBBBBBBBBRTTTTTTTRBBRSSSSSSSSSSSSSSSSSSRBBBR
RBBBBBBBRSSSSSSSSSSSSSSSSSSSSSSRBBBBBBBBBBBBRRRBBRRRRRRRRBBBBBBBBRTTTTTTTRBBRSSSSSSSSSSSSSSSSSSRBBBR
RBBBBBBBRSSSSSSSSSSSSSSSSSSSSSSRBBBBBBBBBBBBBBBBBBBBBBBBBBBBBBBBBRTTTTTTTRBBRSSSSSSSSSSSSSSSSSSRBBBR
RBBBBBBBRSSSSSSSSSSSSSSSSSSSSSSRBBBBBBBBBBBBBBBBBBBBBBBBBBBBBBBBBRTTTTTTTRBBRSSSSSSSSSSSSSSSSSSRBBBR
RBBBBBBBRSSSSSSSSSSSSSSSSSSSSSSRBBBBBBBBBBBBBBBBBBBBBBBBBBBBBBBBBRRRRRBBRRBBRSSSSSSSSSSSSSSSSSSRBBBR
RBBBBBBBRSSSSSSSSSSSSSSSSSSSSSSRBBBBBBBBBBBBBBBBBBBBBBBBBBBBBBBBBBBBBBBBBBBBRSSSSSSSSSSSSSSSSSSRBBBR
RBBBBBBBRSSSSSSSSSSSSSSSSSSSSSSRBBBBBBBBBRRRRRRRRRRRRRRRRRRRRRRBBBBBBBBBBBBBRSSSSSSSSSSSSSSSSSSRBBBR
RBBBBBBBRSSSSSSSSSSSSSSSSSSSSSSRBBBBBBBBBREEEEEEEEEEEEEEEEEEEERBBBBBBBBBBBBBRSSSSSSSSSSSSSSSSSSRBBBR
RBBBBBBBRSSSSSSSSSSSSSSSSSSSSSSRBBBBBBBBBREELLEEEEEEEEEEEEEEEERBBBBBBBBBBBBBRSSSSSSSSSSSSSSSSSSRBBBR
RBBBBBBBRSSSSSSSSSSSSSSSSSSSSSSRBBBBBBBBBREELEEEELELLEEEEELEEERBBBBBBBBBBBBBRSSSSSSSSSSSSSSSSSSRBBBR
RBBBBBBBRSSSSSSSSSSSSSSSSSSSSSSRBBBBBBBBBREEEEEEEEEEEEEEEEEEEERBBBBBBBBBBBBBRSSSSSSSSSSSSSSSSSSRBBBR
RBBBBBBBRSSSSSSSSSSSSSSSSSSSSSSRBBBBBBBBBREEEEEEEEEEEEEEEEEEEERBBBBBBBBBBBBBRSSSSSSSSSSSSSSSSSSRBBBR
RBBBBBBBRSSSSSSSSSSSSSSSSSSSSSSRBBBBBBBBBREEEELLEEEEEEEELEEEEERBBBBBBBBBBBBBRRRRRRBRRRRRRRRRRRRRBBBR
RBBBBBBBRSSSSSSSSSSSSSSSSSSSSSSRBBBBBBBBBREEEEEEEEEELEEEEEELEERBBBBBBBBBBBBBBBBBBBBBBBBBBBBBBBBBBBBR
RBBBBBBBRSSSSSSSSSSSSSSSSSSSSSSRBBBBBBBBBREEEEEEEEEELLEEEEEEEERBBBBBBBBBBBBBBBBBBBBBBBBBBBBBBBBBBBBR
RBBBBBBBRSSSSSSSSSSSSSSSSSSSSSSRBBBBBBBBBRELEEEEEELLEEEEELEEEERBBBBBBBBBBBBBBBBBBBBBBBBBBBBBBBBBBBBR
RBBBBBBBRSSSSSSSSSSSSSSSSSSSSSSRBBBBBBBBBRELEELEEEELEEEEELEEEEBBBBBBBBBBBBBBBBBBBBBBBRRRRRRRRRBBBBBR
RBBBBBBBRSSSSSSSSSSSSSSSSSSSSSSRBBBBBBBBBRELEEEEEEEEEEEEEEEEEEBBBBBBBBBBBBBBBBBBBBBBBRSSSSSSSRBBBBBR
RBBBBBBBRSSSSSSSSSSSSSSSSSSSSSSRBBBBBBBBBRELEELELLEEEEELEEEEEERBBBBBBBBBBBBBBBBBBBBBBRSSSSSSSRBBBBBR
RBBBBBBBRSSSSSSSSSSSSSSSSSSSSSSRBBBBBBBBBREEEELELLEELEEEEEEEEERBBBBBBBBBBBBBBBBBBBBBBRSSSSSSSBBBBBBR
RBBBBBBBRRRRRRRRRRRRRRRBBRRRRRRRBBBBBBBBBREEEEEEEEEELEEELLEEEERBBBBBBBBBBBBBBBBBBBBBBRSSSSSSSRBBBBBR
RBBBBBBBBBBBBBBBBBBBBBBBBBBBBBBBBBBBBBBBBREEEEEEEEEEEEELLEEEEERBBBBBBBBBBBBBBBBBBBBBBRSSSSSSSRBBBBBR
RBBBBBBBBBBBBBBBBBBBBBBBBBBBBBBBBBBBBBBBBREEEEEEEEEELEEEEEEELERBBBBBBBBBBBBBBBBBBBBBBRRRRRRRRRBBBBBR
RBBBBBRRRRRRRBBBBBBBBBBBBBBBBBBBBBBBBBBBBREEELLEEEEEEEEEEEEEEERBBBBBBBBBBBBBBBBBBBBBBBBBBBBBBBBBBBBR
RBBBBBREEEEERBBBBBBBBBBBBBBBBBBBBBBBBBBBBREEEEEEEEEEEEEELEEEEERBBBBBBBBBBBBRRRRRRRRRRRRRBBBBBBBBBBBR
RBBBBBREEEEERBBBBBBBBBBBBBBBBBBBBBBBBBBBBREEEELEELELLLLLLEEEEERBBBBBBBBBBBBRGGGGGGGGGGGRBBBBBBBBBBBR
RBBBBBREEEEERBBBBBBBBBBBBBBBBBBBBBBBBBBBBREEEELEEEEEEEEEEEEEEERBBBBBBBBBBBBRGGGGGGGGGGGRBBBBBBBBBBBR
RBBBBBREEEEERBBBBBBBBBBBBBBBBBBBBBBBBBBBBREEEEEEEEEEEEEEEEEEEERBBRRRRBRBBBBRGGGGGGGGGGGRBBBBBBBBBBBR
RBBBBBREEEEERBBBBBBBBBBBBBBBBBBBBBBBBBBBBRRRRRRRRRRRRRRRRRRRRRRBBRAAAARBBBBRGGGGGGGGGGGRBBBBBBBBBBBR
RBBBBBRRRBRRRBBBBBBBBBBBBBBBBBBBBBBBBBBBBBBBBBBBBBBBBBBBBBBBBBBBBRAAAARBBBBRGGGGGGGGGGGRBBBBBBBBBBBR
RBBBBBBBBBBBBBBBBBBBBBBBBBBBBBBBBBBBBBBBBBBBBBBBBBBBBBBBBBBBBBBBBRAAAARBBBBRGGGGGGGGGGGRBBBBBBBBBBBR
RBBBBBBBBBBBBBBBBBRRRRRRRRRRRRRRRRRRRBBBBBBBBBBBBBBBBBBBBBBBBBBBBRAAAARBBBBRGGGGGGGGGGGRBBBBBBBBBBBR
RBBBBBBBBBBBBBBBBBRGGGGGGGGGGGGGGGGGRBBBBBBBBBBBBBBBBBBBBBBBBBBBBRAAAARBBBBRGGGGGGGGGGGRBBBBBBBBBBBR
RBBBBBBBBBBBBBBBBBRGGGGGGGGGGGGGGGGGRBBBBBBBBBBBBBBBBBBBBBBBBBBBBRAAAARBBBBRGGGGGGGGGGGRBBBBBBBBBBBR
RBBBBBBBBBBBBBBBBBRGGGGGGGGGGGGGGGGGRBBBBBBBBBBBBBBBBBBBBBBBBBBBBRRRRRRBBBBRGGGGGGGGGGGRBBBBBBBBBBBR
RBBBBBBBBBBBBBBBBBRGGGGGWWWWWWGGGGGGRBBBBBBBBBBBBBBBBBBBBBBBBBBBBBBBBBBBBBBRGGGGGGGGGGGRBBBBBBBBBBBR
RBBRRRRRBBBRRRRBBBRGGGWWWWWWWWWWWGGGRBBBBBBBBBBBBBBBBBBBBBBBBBBBBBBBBBBBBBBRGGGGGGGGGGGRBBBBBBBBBBBR
RBBRTTTTTTTTTTRBBBRGGGWWWWWWWWWWWGGGRBBBBBBBBBBBBBBBBBBBBBBBBBBBBBBBBBBBBBBRGGGGGGGGGGGRBBBBBBBBBBBR
RBBRTTTTTTTTTTRBBBRGGWWWWWWWWWWWWWGGRBBBBBBBBBBBBBBBBBBBBBBBBBBBBBBBBBBBBBBRGGGGGGGGGGGRBBBBBBBBBBBR
RBBRTTTTTTTTTTRBBBRGGWWWWWWWWWWWWWGGRBBBBBBBBBBBBBRRRRRBBRRRRRRRBBBBBBBBBBBRGGGGGGGGGGGRBBBBBBBBBBBR
RBBRTTTTTTTTTTRBBBRGGWWWWWWWWWWWWWGGBBBBBBBBBBBBBBREEEEEEEEEEEERBBBBBBBBBBBBGGGGGGGGGGGRBBBBBBBBBBBR
RBBRTTTTTTTTTTRBBBRGGGWWWWWWWWWWWWGGBBBBBBBBBBBBBBREEEEEEEEEEEERBBBBBBBBBBBRGGGGGGGGGGGRBBBBBBBBBBBR
RBBRTTTTTTTTTTRBBBRGGGGWWWWWWWWWWGGGRBBBBBBBBBBBBBREEEEEEELLEEERBBBBBBBBBBBRGGGGGGGGGGGRBBBBBBBBBBBR
RBBRTTTTTTTTTTRBBBRGGGGWWWWWWWWWGGGGRBBBBBBBBBBBBBREEEELLLLLEEERBBBBBBBBBBBRGGGGGGGGGGGRBBBBBBBBBBBR
RBBRTTTTTTTTTTRBBBRGGGGWWWWWWWWWGGGGRBBBBBBBBBBBBBREEEELLLLLLEERBBBBBBBBBBBRRRRRRRRRRRRRBBBBBBBBBBBR
RBBRTTTTTTTTTTRBBBRGGGGGWWWWWWWGGGGGRBBBBBBBBBBBBBRELLLLLLLLLLERBBBBBBBBBBBBBBBBBBBBBBBBBBBBBBBBBBBR
RBBRRRRRRRRRRRRBBBRGGGGGGGGGGGGGGGGGRBBBBBBBBBBBBBRELLLLLLLLLLERBBBBBBBBBBBBBBBBBBBBBBBBBBBBBBBBBBBR
RBBBBBBBBBBBBBBBBBRGGGGGGGGGGGGGGGGGRBBBBBBBBBBBBBRELLLLLLLLLEERBBBBBBBBBBBBBBBBBBBBBBBBBBBBBBBBBBBR
RBBBBBBBBBBBBBBBBBRGGGGGGGGGGGGGGGGGRBBBBBBBBBBBBBREEELLLLLEEEERBBBBBBBBBBBBBBBBBBBBBBBBBBBBBBBBBBBR
RBBBBBBBBBBBBBBBBBRRRRRRBRRRRRRRRRRRRBBBBBBBBBBBBBREEEEEEEEEEEERBBBBBBBBBBBBBBBBBBBBBBBBBBBBBBBBBBBR
RBBBBBBBBBBBBBBBBBBBBBBBBBBBBBBBBBBBBBBBBBBBBBBBBBRRRRRRRRRRRRRRBBBBBBBBBBBBBRRRRRBRRRRBBBBBBBBBBBBR
RBBBBBBBBBBBBBBBBBBBBBBBBBBBBBBBBBBBBBBBBBBBBBBBBBBBBBBBBBBBBBBBBBBBBBBBBBBBBRAAAAAAAARBBBBBBBBBBBBR
RBBBBBBBBBBBBBBBBBBBBBBBBBBBBBBBBBBBBBBBBBBBBBBBBBBBBBBBBBBBBBBBBBBBBBBBBBBBBRAAAAAAAARBBBBBBBBBBBBR
RBBBBBBBBBBBBBBBBBBBBBBBBBBBBBBBBBBBBBBBBBBBBBBBBBBBBBBBBBBBBBBBBBBBBBBBBBBBBRAAAAAAAARBBBBBBBBBBBBR
RBBBBBBBBBBBBBBBBBBBBBBBBBBBBBBBBBBBBBBBBBBBBBBBBBBBBBBBBBBBBBBBBBBBBBBBBBBBBRAAAAAAAARBBBBBBBBBBBBR
RBBBBBBBBBBBBBBBBBBBBBBBBBBBBBBBBBBBBBBBBBBBBBBBBBBBBBBBBBBBBBBBBBBBBBBBBBBBBRRRRRRRRRRBBBBBBBBBBBBR
RBBBBBBBBBBBBBBBBBBBBBBBBBBBBBBBBBBBBBBBBBBBBBBBBBBBBBBBBBBBBBBBBBBBBBBBBBBBBBBBBBBBBBBBBBBBBBBBBBBR
RRRRRRRRRRRRRRRRRRRRRRRRRRRRRRRRRRRRRRRRRRRRRRRRRRRRRRRRRRRRRRRRRRRRRRRRRRRRRRRRRRRRRRRRRRRRRRRRRRRR
