##################RRRRRRRRR#######################
#RRRRRRRRR#RRRRRRRRBBBBBBBR#RRRRRRRRRRRRRRRRRRRRR#
#RBBBBBBBR#RBBBBBBBBBBBBBBR#RBBBBBBBBBBBBBBBBBBBR#
#RBBBBBBBR#RBBBBBBBBBBBBBBR#RBBBBBBBBBBBBBBBBBBBR#
#RBBBBBBBR#RBBBBBBBBBBBBBBR#RBBBBBBBBBBBBBBBBBBBR#
#RBBB@BBBR#RBBBBBBBBBBBBBBR#RBBBBBBBBBBBBBBBBBBBR#
#RBBBBBBBR#RBBBBBBBBBBBBBBR#RBBBBBBBBBBBBBBBBBBBR#
#RBBBBBBBR#RBBBBBBBBBBBBBBR#RBBBBBBBBBBBBBBBBBBBR#
#RBBBBBBBR#RBBBBBBBBBBBBBBR#RBBBBBBBBBBBBBBBBBBBR#
#RBBBBBBBR#RRBRRRRRRRRRRRRR#RBBBBBBBBBBBBBBBBBBBR#
#RBBBBBBBR##RBR#############RBBBBBBBBBBBBBBBBBBBR#
#RBBBBBBBR#RRBRRRRRRRR######RBBBBBBBBBBBBBBBBBBBR#
#RRRRBRRRR#RBBBBBBBBBR######RRRRBBBBBBBBBBBBBBBBR#
####RBR####RBBBBBBBBBR#########RBBBBBBBBBBBBBBBBR#
####RBR####RBBBBBBBBBR#########RBBBBBBBBRRRRRRRRR#
#RRRRBR####RBBBBBBBBBRRRRRRRRRRRBBBBBBBBR#########
#RBBBBR####RBBBBBBBBBBBBBBBBBBBBBBBBBBBBR#RRRRRRR#
#RBBBBR####RBRRRBBBBBRRRRRRRRRRRBBBBBBBBR#RBBBBBR#
#RBBBBRRRRRRBR#RRRRRRR#########RRRRRRRBBRRRBBBBBR#
#RBBBBBBBBBBBR#######################RBBBBBBBBBBR#
#RBBBBBBBBBBBR#RRRRRRRRRRRRRRRRRRR###RBBRRRBBBBBR#
#RBBBBBBBBBBBR#RBBBBBBBBBBBBBBBBBR###RBBR#RBBBBBR#
#RBBBBBBBBBBBRRRBBBBBBBBBBBBBBBBBR###RBBR#RRRRRRR#
#RBBBBBBBBBBBBBBBBBBBBBBBBBBBBBBBRRRRRBBR#########
#RBBBBBBBBBBBBBBBBBBBBBBBBBBBBBBBBBBBBBBR##RRRRRR#
#RBBBBBBBBBBBBRRRBBBBBBBBBBBBBBBBRRRRRBBRRRRBBBBR#
#RBBBBBBBBBBBBR#RBBBBBBBBBBBBBBBBR###RBBBBBBBBBBR#
#RBBBRRRRRRRRRR#RBBBBBRRRRRRRBBBBR###RBBRRRBBBBBR#
#RRRRR##########RRRRRRR#####RBBBBR###RRRR#RBBBBBR#
############################RRRRRR########RRRRRRR#
