RRRRRRRRRRRRRRRRRRRRRRRRRRRRRRRRRRRRRRRRRRRRRRRRRR
RBBBBBBBBRBBBBBBBBBBBRBBBBBBBBRBBBBBBBBBBBBBBBBBBR
RBBBBBBBBRBBBBBBBBBBBRBBBBBBBBRBBBBBBBBBBBBBBBBBBR
RBBBBBBBBRBBBBBBBBBBBRBBBBBBBBRBBBBBBBBBBBBBBBBBBR
RBBBBBBBBRBBBBBBBBBBBRBBBBBBBBBBBBBBBBBBBBBBBBBBBR
RBBBBBBBBRBBBBBBBBBBBRBBBBBBBBBBBBBBBBBBBBBBBBBBBR
RBBBBBBBBRBBBBBBBBBBBRBBBBBBBBRBBBBBBBBBBBBBBBBBBR
RBBBBBBBBRBBBBBBBBBBBRBBBBBBBBRBBBBBBBBBBBBBBBBBBR
RBBBBBBBBRBBBBBBBBBBBRBBBBBBBBRBBBBBBBBBBBBBBBBBBR
RBBBBBBBBRBBBBBBBBBBBRBBBBBBBBRBBBBBBBBBBBBBBBBBBR
RRRRRRBBBRRBBRRBBBBBBRRRRBBRRRRBBBBBBBBBBBBBBBBBBR
RBBBBBBBBBBBBBRBBBBBBRBBBBBBBBRBBBBBBBBBBBBBBBBBBR
RBBBBBBBBBBBBBRBBBBBBRBBBBBBBBRBBBBBBBBBBBBBBBBBBR
RBBBBBBBBBBBBBRBBBBBBRBBBBBBBBRBBBBBBBBBBBBBBBBBBR
RBBBBBBBBBBBBBRBBBBBBRBBBBBBBBRBBBBBBBBBBBBBBBBBBR
RBBBBBBBBBBBBBRBBBBBBRBBBBBBBBRBBBBBBBBBBBBBBBBBBR
RBBBBBBBBBBBBBRBBBBBBRBBBBBBBBRBBBBBBBBBBBBBBBBBBR
RBBBBBBBBBBBBBRBBBBBBRBBBBBBBBRRRRRRRRRRRRRRRRRRRR
RBBBBBBBBBBBBBRBBBBBBRBBBBBBBBBBBBBRBBBBBBBBBBBBBR
RRRRRRRRRRRRRRRBBBBBBRBBBBBBBBBBBBBRBBBBBBBBBBBBBR
RBBBBBBBBBBRBBBBBBBBBRBBBBBBBBBBBBBBBBBBBBBBBBBBBR
RBBBBBBBBBBRBBBBBBBBBRBBBBBBBBBBBBBRBBBBBBBBBBBBBR
RBBBBBBBBBBRBBBBBBBBBBBBBBBBBBBBBBBRBBBBBBBBBBBBBR
RBBBBBBBBBBRBBBBBBBBBBBBBBBBBBBBBBBRBBBBBBBBBBBBBR
RBBBBBBBBBBRBBRRRRRRRRRRRRRRRRRRRRRRBBBBBBBBBBBBBR
RBBBBBBBBBBRBBBBBBBBBBBBBBBBBBBBBBBRBBBBBBBBBBBBBR
RBBBBBBBBBBRBBBBBBBBBBBBBBBBBBBBBBBRBBBBBBBBBBBBBR
RBBBBBBBBBBBBBBBBBBBBBBBBBBBBBBBBBBRBBBBBBBBBBBBBR
RBBBBBBBBBBBBBBBBBBBBBBBBBBBBBBBBBBRBBBBBBBBBBBBBR
RRRRRRRRRRRRRRRRRRRRRRRRRRRRRRRRRRRRRRRRRRRRRRRRRR
