GGGGGGGGGGGGGGGGGGGSSSSSSSSSSSSSSGGGGGGGGGGGGGGGGG
GGGGGGGGGGGGGGGGSSSSSSSSSSSSSSSSSSGGGGGGGGGAAAAGGG
GGGGGGGGGGGGGGSSSSSSSSSSSSSSSSSSSSSGGGGGGGAAAAAAGG
GGGGGGGGGGGGGSSSSSSSSSSSSSSSSSSSSSSSGGGGGAAAAAAAAG
GGGGGGGGGGGGSSSSSSSSSWWWWWWWWWWSSSSSSGGGGAAAAAAAAG
GGGGGGGGGGGSSSSSSSWWWWWWWWWWWWWWSSSSSGGGGAAAAAAAAG
GGGGGGGGGGSSSSSSWWWWWWWWWWWWWWWWWSSSSSGGGAAAAAAAAG
GGGGGGGGGSSSSSSWWWWWWWWWWWWWWWWWWWSSSSSGGGAAAAAAGG
GGGGGGGGGSSSSSWWWWWWWWWWWWWWWWWWWWSSSSSGGGGAAAAGGG
GGGGGGSSSSSSSWWWWWWWWWWWWWWWWWWWWWWSSSSSGGGGGGGGGG
GGGGGSSSSSSSSWWWWWWWWWWWWWWWWWWWWWWSSSSSSGGGGGGGGG
GGGGSSSSSSSSWWWWWWWWWWWWWWWWWWWWWWWWSSSSSSGGGGGGGG
GGGSSSSSSSSSWWWWWWWWWWWWWWWWWWWWWWWWWSSSSSGGGGGGGG
GGGSSSSSSSSWWWWWWWWWWWWWWWWWWWWWWWWWWWSSSSSGGGGGGG
GGGSSSSSSBBBBBBBBBBBBBBBBBBWWWWWWWWWWWSSSSSGGGGGGG
GGGSSSSSBBBBBBBBBBBBBBBBBBBWWWWWWWWWWWWSSSSGGGGGGG
GGGSSSSSSSWWWWWWWWWWWWWWWWWWWWWWWWWWWWWSSSSGGGGGGG
GGGGSSSSSSSWWWWWWWWWWWWWWWWWWWWWWWWWWWWSSSSGGGGGGG
GGGGSSSSSSSWWWWWWWWWWWWWWWWWWWWWWWWWWWWSSSGGGGGGGG
GGGGSSSSSSSWWWWWWWWWWWWWWWWWWWWWWWWWWWSSSSGGGGGGGG
GGGGSSSSSSSSWWWWWWWWWWWWWWWWWWWWWWWWWSSSSSGGGGGGGG
GGGGGSSSSSSSSWWWWWWWWWWWWWWWWWWWWWWWSSSSSSGGGGGGGG
GGGGGSSSSSSSSWWWWWWWWWWWWWWWWWWWWWWWSSSSSSGGGGGGGG
GGGGGSSSSSSSSWWWWWWWWWWWWWWWWWWWWWSSSSSSSSGGGGGGGG
GGGGGGSSSSSSSSWWWWWWWWWWWWWWWWWWWSSSSSSSGGGGGGGGGG
GGGGGGGSSSSSSSSWWWWWWWWWWWWWWSSSSSSSSSSGGGGGGGGGGG
GGGGGGGGGSSSSSSSSWWWWWWWWWWSSSSSSSSSSSSGGGGGGGGGGG
GGGGGGGGGGGGSSSSSSSSSSSSSSSSSSSSSSSSSSGGGGGGGGGGGG
GGGGGGGGGGGGGGGGSSSSSSSSSSSSSSSSSSSGGGGGGGGGGGGGGG
GGGGGGGGGGGGGGGGGGGGGGGGGGGGGGGGGGGGGGGGGGGGGGGGGG
