RRRRRRRRRRRRRRRRRRRRRRRRRRRRRRRRRRRRRRRRRRRRRRRRRR
RAAAAAAAARBBBBBBBBBBBRTTTTTTTTRSSSSSSSSSSSSSSSSSSR
RAAAAAAAARBBBBBBBBBBBRTTTTTTTTRSSSSSSSSSSSSSSSSSSR
RAAAAAAAARBBBBBBBBBBBRTTTTTTTTRSSSSSSSGGGGSSSSSSSR
RAAAAAAAARBBBBBBBBBBBRTTTTTTTTTSSSSSGGGGGGGGSSSSSR
RAAAAAAAARBBBBBBBBBBBRTTTTTTTTTSSSSGGGWWWWWGSSSSSR
RAAAAAAAARBBBBBBBBBBBRTTTTTTTTRSSSSGWWWWWWWGGGSSSR
RAAAAAAAARBBBBBBBBBEBRTTTTTTTTRSSSGGWWWWWWWWWGSSSR
RAAAAAAAARBBBBBBBBBBBRTTTTTTTTRSSSGGWWWWWWWWWGGSSR
RAAAAAAAARBBBBBBBBBBBRTTTTTTTTRSSSGGWWWWWWWWWGGSSR
RRRRRRBBRRRBBRRBEBBBBRRRREERRRRSSSSGWWWWWWWWWGSSSR
RBBBBBBBBBBBBBRBBBEBBREEEEEEEERSSSSGGWWWWWWWGGSSSR
RBBBBBBBBBBBBBRBBBBBEREEEEEEEERSSSSSGGWWWWGGGSSSSR
RBBBBBBBBBBBBBRBEBBBBREEEEEEEERSSSSSSGGGGGGSSSSSSR
RBBBBBBBBBBBBBRBBBEBBREEEEEEEERSSSSSSSSGGGSSSSSSSR
RBBBBBBBBBBBBBRBEBEBBREEEEEEEERSSSSSSSSSSSSSSSSSSR
RBBBBBBBBBBBBBRBEBBEEREEEEEEEERSSSSSSSSSSSSSSSSSSR
RBBBBBBBBBBBBBREBEBBEREEEEEEEERRRRRRRRRRRRRRRRRRRR
RBBBBBBBBBBBBBREBEBEBREEEEEEEEEEEEERAAAAAAAAAAAAAR
RRRRRRRRRRRRRRRBEBBEEREEEEEEEEEEEEERAAAAAAAAAAAAAR
RTTTTTTTTTTREEEBEEBEEREEEEEEEEEEEEEEAAAAAAAAAAAAAR
RTTTTTTTTTTREEEEBEEBEREEEEEEEEEEEEERAAAAAAAAAAAAAR
RTTTTTTTTTTREEEEEEEEEEEEEEEEEEEEEEERAAAAAAAAAAAAAR
RTTTTTTTTTTREEEEEEEEEEEEEEEEEEEEEEERAAAAAAAAAAAAAR
RTTTTTTTTTTREERRRRRRRRRRRRRRRRRRRRRRAAAAAAAAAAAAAR
RTTTTTTTTTTREEELLLLLLLLLLLLEEEELLEERAAAAAAAAAAAAAR
RTTTTTTTTTTREEELLEEELEEELLLELLELLEERAAAAAAAAAAAAAR
RTTTTTTTTTTEEEEEEELELELEEEEELLELLEERAAAAAAAAAAAAAR
RTTTTTTTTTTEEEELLLLEEELLLLLLLLEEEEERAAAAAAAAAAAAAR
RRRRRRRRRRRRRRRRRRRRRRRRRRRRRRRRRRRRRRRRRRRRRRRRRR
